{
  "schema": "yaya.adaptive_engine.curriculum_levels.v1",
  "scope": "primary_math_g5_g6_pep",
  "standard": "义务教育数学课程标准(2022年版)",
  "mapping": {
    "A": "了解",
    "B": "理解",
    "C": "掌握",
    "D": "运用",
    "source": "PEP教师教学用书 + 2022新课标 逐课时标注"
  },
  "levels": [
    {
      "level": "A",
      "label": "了解",
      "description": "了解——知道是什么。能识别、说出、举例。对应新课标最低认知层级。",
      "knowledgeCodes": [
        "M5S1-0",
        "M5S1-15",
        "M5S1-27",
        "M5S1-28",
        "M5S1-29",
        "M5S1-34",
        "M5S1-59",
        "M5S2-7",
        "M5S2-8",
        "M6S1-25",
        "M6S1-26",
        "M6S1-31",
        "M6S2-0",
        "M6S2-9",
        "M6S2-13",
        "M5S2-28"
      ]
    },
    {
      "level": "B",
      "label": "理解",
      "description": "理解——知道为什么。能说明算理、推导过程、关系。对应新课标第二认知层级。",
      "knowledgeCodes": [
        "M5S1-3",
        "M5S1-4",
        "M5S1-5",
        "M5S1-6",
        "M5S1-9",
        "M5S1-19",
        "M5S1-20",
        "M5S1-23",
        "M5S1-30",
        "M5S1-35",
        "M5S1-38",
        "M5S1-41",
        "M5S1-42",
        "M5S1-49",
        "M5S1-50",
        "M5S1-52",
        "M5S1-54",
        "M5S1-55",
        "M5S1-61",
        "M5S1-62",
        "M5S2-0",
        "M5S2-1",
        "M5S2-6",
        "M5S2-11",
        "M5S2-13",
        "M5S2-15",
        "M5S2-17",
        "M5S2-21",
        "M5S2-25",
        "M5S2-27",
        "M6S1-0",
        "M6S1-2",
        "M6S1-7",
        "M6S1-10",
        "M6S1-12",
        "M6S1-14",
        "M6S1-15",
        "M6S1-20",
        "M6S1-21",
        "M6S1-27",
        "M6S1-29",
        "M6S1-34",
        "M6S1-40",
        "M6S1-42",
        "M6S2-5",
        "M6S2-14",
        "M6S2-16",
        "M6S2-20",
        "M6S2-21",
        "M6S2-22",
        "M6S2-23",
        "M6S2-26",
        "M5S2-31"
      ]
    },
    {
      "level": "C",
      "label": "掌握",
      "description": "掌握——能独立正确完成。熟练计算、规范应用、解决标准题型。对应新课标第三认知层级。",
      "knowledgeCodes": [
        "M5S1-1",
        "M5S1-2",
        "M5S1-7",
        "M5S1-8",
        "M5S1-10",
        "M5S1-13",
        "M5S1-14",
        "M5S1-16",
        "M5S1-17",
        "M5S1-18",
        "M5S1-21",
        "M5S1-22",
        "M5S1-24",
        "M5S1-25",
        "M5S1-26",
        "M5S1-33",
        "M5S1-36",
        "M5S1-37",
        "M5S1-39",
        "M5S1-40",
        "M5S1-43",
        "M5S1-44",
        "M5S1-45",
        "M5S1-51",
        "M5S1-53",
        "M5S1-56",
        "M5S1-57",
        "M5S1-58",
        "M5S1-60",
        "M5S1-63",
        "M5S1-64",
        "M5S1-65",
        "M5S1-66",
        "M5S1-67",
        "M5S1-68",
        "M5S1-69",
        "M5S2-2",
        "M5S2-3",
        "M5S2-4",
        "M5S2-5",
        "M5S2-9",
        "M5S2-10",
        "M5S2-12",
        "M5S2-16",
        "M5S2-18",
        "M5S2-19",
        "M5S2-20",
        "M5S2-22",
        "M5S2-23",
        "M5S2-24",
        "M5S2-26",
        "M6S1-1",
        "M6S1-3",
        "M6S1-4",
        "M6S1-5",
        "M6S1-6",
        "M6S1-11",
        "M6S1-13",
        "M6S1-16",
        "M6S1-17",
        "M6S1-22",
        "M6S1-23",
        "M6S1-28",
        "M6S1-30",
        "M6S1-32",
        "M6S1-35",
        "M6S1-36",
        "M6S1-37",
        "M6S1-38",
        "M6S1-41",
        "M6S1-43",
        "M6S1-44",
        "M6S1-45",
        "M6S1-46",
        "M6S2-1",
        "M6S2-2",
        "M6S2-3",
        "M6S2-4",
        "M6S2-6",
        "M6S2-7",
        "M6S2-10",
        "M6S2-11",
        "M6S2-12",
        "M6S2-17",
        "M6S2-18",
        "M6S2-19",
        "M6S2-24",
        "M6S2-27",
        "M6S2-28",
        "M6S2-29",
        "M6S2-30",
        "M6S2-31",
        "M6S2-32",
        "M6S2-33",
        "M6S2-34",
        "M6S2-35",
        "M6S2-36",
        "M6S2-37",
        "M5S2-29",
        "M5S2-32"
      ]
    },
    {
      "level": "D",
      "label": "运用",
      "description": "运用——能解决新情境问题。综合多个知识点、选择策略、解决非标准/开放性问题。对应新课标最高认知层级。",
      "knowledgeCodes": [
        "M5S1-11",
        "M5S1-12",
        "M5S1-31",
        "M5S1-32",
        "M5S1-46",
        "M5S1-47",
        "M5S1-48",
        "M5S2-14",
        "M6S1-8",
        "M6S1-9",
        "M6S1-18",
        "M6S1-19",
        "M6S1-24",
        "M6S1-33",
        "M6S1-39",
        "M6S2-8",
        "M6S2-15",
        "M6S2-25",
        "M5S2-30",
        "M5S2-33"
      ]
    }
  ],
  "stats": {
    "total": 189,
    "A_了解": 16,
    "B_理解": 53,
    "C_掌握": 100,
    "D_运用": 20
  }
}